9;9;map9;https://t1.uc.ltmcdn.com/fr/posts/7/4/6/quelle_est_la_difference_entre_riviere_et_fleuve_12647_600_square.jpg;150000000;0
1;1;1;1;1;1;1;1;1;
1;w;1;1;1;w;1;1;1;
1;1;w;1;1;1;w;1;1;
1;1;1;0;1;1;1;w;1;
1;w;1;1;1;1;1;1;1;
1;w;w;1;1;1;1;w;1;
1;1;w;1;1;1;w;1;1;
1;1;1;1;1;w;1;1;1;
1;1;1;1;1;1;1;w;w;
